[console_scripts]
analyze-mentions-of-ids=src.scripts.analyze_mentions_of_ids:main
anyuri-strings-to-iris=nmdc_schema.anyuri_strings_to_iris:expand_curies
check-examples-class-coverage=src.scripts.check_examples_class_coverage:main
class-instantiation-counts=src.scripts.class_instantiation_counts:process_data
create-migrator=nmdc_schema.migrators.cli.create_migrator:create_migrator
database-to-json-list-files=src.scripts.database_to_json_list_files:split_yaml_to_json
date-created-blank-node=src.scripts.date_created_blank_node:print_timestamp
fetch-nmdc-schema=nmdc_schema.nmdc_data:get_nmdc_jsonschema
get-study-id-from-filename=src.scripts.get_study_id_from_filename:main
get-study-related-records=src.scripts.nmdc_database_tools:cli
interleave-yaml=src.scripts.interleave_yaml:process_yaml
migration-recursion=nmdc_schema.migration_recursion:main
nmdc-data=nmdc_schema.nmdc_data:cli
nmdc-ncbi-mapping=src.scripts.ncbi_nmdc_exact_term_matching:cli
nmdc-version=nmdc_schema.nmdc_version:cli
pure-export=nmdc_schema.dump_single_modality:cli
report-biosamples-per-study=src.scripts.report_biosamples_per_study:query_biosamples
report-usages=src.scripts.report_usages:display_slot_usage
run-migrator=nmdc_schema.migrators.cli.run_migrator:run_migrator
schema-pattern-linting=src.scripts.schema_pattern_linting:main
schema-view-relation-graph=src.scripts.schema_view_relation_graph:cli
scrutinize-elements=src.scripts.scrutinize_elements:process_schema_elements
slot-range-type-reporter=src.scripts.slot_range_type_reporter:cli
units-mongodb-analyze=units.scripts.mongodb_analyze_units:main
units-schema-convert=units.scripts.schema_convert_to_ucum:main
units-schema-extract=units.scripts.schema_extract_preferred_units:main
units-schema-extract-slot-unit-pairs=units.scripts.schema_expand_storage_units:main
units-schema-generate=units.scripts.schema_generate_yq_commands:main
units-testdata-check=units.scripts.testdata_check_has_unit:main
units-testdata-extract=units.scripts.testdata_extract_quantity_values:main
units-ucum-validate=units.scripts.ucum_validate_units:main

